1111111111111
10010000001C1
1111111010101
100000E000P01
1111111111111