1111111111111
100100000C0C1
111111101C001
1C0000E010P01
1111111111111