1111111111111
10010001C11C1
1111100010101
100001E100P01
1111111111111