1111111111111
1001000111111
1111100010101
100001E00CP01
11111111111110