111111111111111111111
1E1000000000000000001
111001010010000000001
101001001010101000101
1P0000000C00C000000C1
111111111111111111111